adversaries|(противники, противники); someone who offers opposition; Synonims ['resister', 'opposer', 'antagonist'] 
silhouette|(силуэт, силуэт); an outline of a solid object (as cast by its shadow); Synonims [] 
sternly|(сурово, строго); with sternness; in a severe manner; Synonims ['severely'] 
envelope|(конверт, конверт); a flat (usually rectangular) container for a letter, thin package, etc.; Synonims ['gasbag'] 
abject|(презрение, отвратительный); of the most contemptible kind; Synonims ['low', 'miserable', 'low-down'] 
benefactor|(благотворитель, благодетель); a person who helps people or institutions (especially with financial help); Synonims ['helper'] 
carpenter|(плотник, плотник); a woodworker who makes or repairs wooden objects; Synonims [] 
imperceptibly|(незаметно, незаметно); in an imperceptible manner or to an imperceptible degree; Synonims ['unnoticeably'] 
bracket|(кронштейн, скобка); a category falling within certain defined limits; Synonims ['angle_bracket', 'square_bracket', 'bracket_out'] 
grim|(мрачный, мрачный); not to be placated or appeased or moved by entreaty; Synonims ['forbidding', 'inexorable', 'low-spirited'] 
indispensable|(Незаменимый, незаменимый); not to be dispensed with; essential; Synonims ['essential'] 
counsel|(адвокат, адвокат); a lawyer who pleads cases in court; Synonims ['guidance', 'advocate', 'counselor-at-law'] 
extraterrestrial|(Внеземные, внеземной); a form of life assumed to exist outside the Earth or its atmosphere; Synonims ['extraterrestrial_being', 'alien'] 
quagmire|(трясина, трясина); a soft wet area of low-lying land that sinks underfoot; Synonims ['quag', 'mire', 'slack'] 
alluring|(манящий, заманчивый); dispose or incline or entice to; Synonims ['tempting', 'beguiling', 'enticing'] 
mien|(миен, выражение лица); dignified manner or conduct; Synonims ['presence', 'bearing', 'comportment'] 
ascertain|(уточнить, констатировать); establish after a calculation, investigation, experiment, survey, or study; Synonims ['check', 'control', 'watch'] 
inkling|(Чернила, подозрение); a slight suggestion or vague understanding; Synonims ['glimmer', 'glimmering', 'intimation'] 
outages|(отключения, перебои в работе); the amount of something (as whiskey or oil) lost in storage or transportation; Synonims ['outage'] 
begrudge|(ущемлять, завидовать); be envious of; set one's heart on; Synonims ['resent', 'envy'] 
ignorant|(невежда, невежественный); uneducated in general; lacking knowledge or sophistication; Synonims ['unknowing', 'unlettered', 'illiterate'] 
superimposed|(наложенные, наложенный); place on top of; Synonims ['layered', 'overlying', 'lay_over'] 
scrutiny|(проверка, исследование); the act of examining something closely (as for mistakes); Synonims ['examination'] 
zeal|(усердие, рвение); a feeling of strong eagerness (usually in favor of a person or cause); Synonims ['eagerness', 'ardour', 'forwardness'] 
chastening|(наказание, наказание); a rebuke for making a mistake; Synonims ['objurgate', 'temper', 'chastise'] 
deciphering|(расшифровка, расшифровка); convert code into ordinary language; Synonims ['decipher', 'decode', 'trace'] 
glints|(блики, блестки); a momentary flash of light; Synonims ['spark', 'gleam', 'glitter'] 
persecuted|(преследуемый, преследовали); cause to suffer; Synonims ['oppress', 'persecute'] 
ludicrous|(смехотворный, нелепый); broadly or extravagantly humorous; resembling farce; Synonims ['nonsensical', 'preposterous', 'cockeyed'] 
stocky|(коренастый, коренастый); having a short and solid form or stature; Synonims ['heavyset', 'thickset', 'thick'] 
intricacy|(замысловатость, запутанность); marked by elaborately complex detail; Synonims ['elaborateness', 'elaboration', 'involution'] 
acute|(острый, острый); a mark (') placed above a vowel to indicate pronunciation; Synonims ['sharp', 'ague', 'penetrative'] 
derivation|(деривация, вывод); the source or origin from which something derives (i.e. comes or issues); Synonims ['filiation', 'deriving', 'etymologizing'] 
marrow|(костный мозг, костный мозг); the fatty network of connective tissue that fills the cavities of bones; Synonims ['marrow_squash', 'nitty-gritty', 'bone_marrow'] 
gauge|(манометр, измерять); a measuring instrument for measuring and indicating a quantity such as the thickness of wire or the amount of rain etc.; Synonims ['estimate', 'standard_of_measurement', 'guess'] 
squabbling|(ссориться, ссора); argue over petty things; Synonims ['bicker', 'squabble', 'brabble'] 
parasol|(зонт, зонтик); a handheld collapsible source of shade; Synonims ['sunshade'] 
contemptuous|(презрительный, презрительный); expressing extreme contempt; Synonims ['scornful', 'insulting', 'disdainful'] 
indulgence|(индульгенция, снисходительность); an inability to resist the gratification of whims and desires; Synonims ['tomfoolery', 'self-indulgence', 'leniency'] 
dimmed|(затемненный, затемнен); switch (a car's headlights) from a higher to a lower beam; Synonims ['dip', 'blur', 'dim'] 
constituencies|(избирательные округа, избирательные округа); the body of voters who elect a representative for their area; Synonims ['constituency'] 
dish|(блюдо, блюдо); a piece of dishware normally used as a container for holding or serving food; Synonims ['stunner', 'dish_up', 'dish_out'] 
fissile|(расщепляющееся, делящийся); capable of undergoing nuclear fission; Synonims ['fissionable'] 
churlish|(глумливый, грубый); rude and boorish; Synonims [] 
entail|(влечет за собой, влечь за собой); land received by fee tail; Synonims ['fee-tail', 'mean', 'imply'] 
modest|(скромно, скромный); marked by simplicity; having a humble opinion of yourself; Synonims ['low', 'small', 'minor'] 
apprehensive|(опасения, опасающийся); quick to understand; - Nathaniel Hawthorne; Synonims ['worried', 'discerning'] 
imminent|(Неминуемое, неизбежный); close in time; about to occur; Synonims ['close_at_hand', 'at_hand', 'impending'] 
wig|(парик, парик); hairpiece covering the head and made of real or synthetic hair; Synonims ['wigging'] 
chasm|(пропасть, пропасть); a deep opening in the earth's surface; Synonims [] 
involuntary|(принудительный, непроизвольный); not subject to the control of the will; ; ; ; - John F.Kennedy; Synonims ['nonvoluntary', 'unvoluntary'] 
bystanders|(случайные прохожие, прохожие); a nonparticipant spectator; Synonims ['bystander'] 
conjectures|(предположения, догадки); a hypothesis that has been formed by speculating or conjecturing (usually with little hard evidence); Synonims ['guess', 'theorise', 'hypothesis'] 
commemorate|(отметить, почтить память); mark by some ceremony or observation; Synonims ['remember', 'memorialize', 'immortalise'] 
