envelope|(конверт); a flat (usually rectangular) container for a letter, thin package, etc.; Synonims ['gasbag'] 
mien|(миен,выражение лица); dignified manner or conduct; Synonims ['bearing', 'comportment', 'presence'] 
ignorant|(невежественный,невежда); uneducated in general; lacking knowledge or sophistication; Synonims ['unlearned', 'nescient', 'unwitting'] 
parasol|(зонт,зонтик); a handheld collapsible source of shade; Synonims ['sunshade'] 
abject|(отвратительный,презрение); of the most contemptible kind; Synonims ['low-down', 'scurvy', 'unhopeful'] 
chasm|(пропасть); a deep opening in the earth's surface; Synonims [] 
chastening|(наказание); a rebuke for making a mistake; Synonims ['subdue', 'temper', 'moderate'] 
sternly|(сурово,строго); with sternness; in a severe manner; Synonims ['severely'] 
dimmed|(затемненный,затемнен); switch (a car's headlights) from a higher to a lower beam; Synonims ['blind', 'slur', 'dim'] 
stocky|(коренастый); having a short and solid form or stature; Synonims ['thickset', 'compact', 'thick'] 
begrudge|(ущемлять,завидовать); be envious of; set one's heart on; Synonims ['resent', 'envy'] 
counsel|(адвокат); a lawyer who pleads cases in court; Synonims ['guidance', 'pleader', 'advocate'] 
deciphering|(расшифровка); convert code into ordinary language; Synonims ['decrypt', 'trace', 'decode'] 
indulgence|(снисходительность,индульгенция); an inability to resist the gratification of whims and desires; Synonims ['indulging', 'humoring', 'craziness'] 
apprehensive|(опасения,опасающийся); quick to understand; - Nathaniel Hawthorne; Synonims ['discerning', 'worried'] 
commemorate|(отметить,почтить память); mark by some ceremony or observation; Synonims ['mark', 'immortalise', 'record'] 
imminent|(Неминуемое,неизбежный); close in time; about to occur; Synonims ['impendent', 'at_hand', 'close_at_hand'] 
benefactor|(благотворитель,благодетель); a person who helps people or institutions (especially with financial help); Synonims ['helper'] 
imperceptibly|(незаметно); in an imperceptible manner or to an imperceptible degree; Synonims ['unnoticeably'] 
superimposed|(наложенный,наложенные); place on top of; Synonims ['lay_over', 'layered', 'superimpose'] 
silhouette|(силуэт); an outline of a solid object (as cast by its shadow); Synonims [] 
entail|(влечь за собой,влечет за собой); land received by fee tail; Synonims ['implicate', 'fee-tail', 'mean'] 
gauge|(измерять,манометр); a measuring instrument for measuring and indicating a quantity such as the thickness of wire or the amount of rain etc.; Synonims ['calibre', 'approximate', 'judge'] 
carpenter|(плотник); a woodworker who makes or repairs wooden objects; Synonims [] 
bracket|(кронштейн,скобка); a category falling within certain defined limits; Synonims ['angle_bracket', 'bracket_out', 'wall_bracket'] 
outages|(перебои в работе,отключения); the amount of something (as whiskey or oil) lost in storage or transportation; Synonims ['outage'] 
constituencies|(избирательные округа); the body of voters who elect a representative for their area; Synonims ['constituency'] 
grim|(мрачный); not to be placated or appeased or moved by entreaty; Synonims ['gloomy', 'disconsolate', 'grisly'] 
contemptuous|(презрительный); expressing extreme contempt; Synonims ['scornful', 'disdainful', 'insulting'] 
marrow|(костный мозг); the fatty network of connective tissue that fills the cavities of bones; Synonims ['heart_and_soul', 'nub', 'sum'] 
acute|(острый); a mark (') placed above a vowel to indicate pronunciation; Synonims ['acute_accent', 'discriminating', 'penetrating'] 
conjectures|(предположения,догадки); a hypothesis that has been formed by speculating or conjecturing (usually with little hard evidence); Synonims ['supposition', 'hypothecate', 'surmisal'] 
adversaries|(противники); someone who offers opposition; Synonims ['opposer', 'opponent', 'antagonist'] 
fissile|(делящийся,расщепляющееся); capable of undergoing nuclear fission; Synonims ['fissionable'] 
indispensable|(Незаменимый,незаменимый); not to be dispensed with; essential; Synonims ['essential'] 
modest|(скромно,скромный); marked by simplicity; having a humble opinion of yourself; Synonims ['small-scale', 'humble', 'pocket-sized'] 
scrutiny|(проверка,исследование); the act of examining something closely (as for mistakes); Synonims ['examination'] 
squabbling|(ссориться,ссора); argue over petty things; Synonims ['niggle', 'pettifog', 'bicker'] 
involuntary|(принудительный,непроизвольный); not subject to the control of the will; ; ; ; - John F.Kennedy; Synonims ['unvoluntary', 'nonvoluntary'] 
quagmire|(трясина); a soft wet area of low-lying land that sinks underfoot; Synonims ['slack', 'morass', 'quag'] 
bystanders|(прохожие,случайные прохожие); a nonparticipant spectator; Synonims ['bystander'] 
derivation|(деривация,вывод); the source or origin from which something derives (i.e. comes or issues); Synonims ['lineage', 'filiation', 'deriving'] 
inkling|(подозрение,Чернила); a slight suggestion or vague understanding; Synonims ['glimmer', 'intimation', 'glimmering'] 
intricacy|(запутанность,замысловатость); marked by elaborately complex detail; Synonims ['elaborateness', 'elaboration', 'involution'] 
wig|(парик); hairpiece covering the head and made of real or synthetic hair; Synonims ['wigging'] 
alluring|(манящий,заманчивый); dispose or incline or entice to; Synonims ['tempt', 'tempting', 'beguiling'] 
glints|(блики,блестки); a momentary flash of light; Synonims ['flicker', 'glint', 'gleam'] 
dish|(блюдо); a piece of dishware normally used as a container for holding or serving food; Synonims ['serve_up', 'looker', 'peach'] 
extraterrestrial|(Внеземные,внеземной); a form of life assumed to exist outside the Earth or its atmosphere; Synonims ['alien', 'extraterrestrial_being'] 
zeal|(рвение,усердие); a feeling of strong eagerness (usually in favor of a person or cause); Synonims ['ardor', 'forwardness', 'readiness'] 
churlish|(глумливый,грубый); rude and boorish; Synonims [] 
ascertain|(уточнить,констатировать); establish after a calculation, investigation, experiment, survey, or study; Synonims ['check', 'insure', 'find_out'] 
persecuted|(преследуемый,преследовали); cause to suffer; Synonims ['oppress', 'persecute'] 
ludicrous|(смехотворный,нелепый); broadly or extravagantly humorous; resembling farce; Synonims ['ridiculous', 'farcical', 'nonsensical'] 
